R 1920 1080
NO textures/bas.png
SO textures/bas.png
WE textures/bas.png
EA textures/bas.png
S textures/bas.png
C 5,9,50
F 50,0,0


11111111111111
11111100111111
11111120111111
11111102111111
11111120111111
11111102111111
11111120111111
11111102111111
11111102111111
11111120111111
11111100111111
11111102111111
11111120111111
11111102111111
11111102111111
11111120111111
11111100111111
11111102111111
11111120111111
11111102111111
11111102111111
11111120111111
11111100111111
11111102111111
11111120111111
11111102111111
11111102111111
11111120111111
11111100111111
11111102111111
10200200020001
10000000000001
100000N0000001
10200200020001
11111111111111


