NO ./textures/awesomeface.png
R 16384 16384
SO ./textures/awesomeface.png
WE ./textures/awesomeface.png
EA ./textures/awesomeface.png
S ./textures/sprite.png
F 0,0,255
C 255,0,3



111111111
100000001
101100001
100100001
101100021
100000021
111101111
111101111
110000001
100000001
100000001
110000N01
111101111
111111111
