R 1200 800
NO image/yellow.png
WE image/pink.png
SO image/blue.png
EA image/green.png

S image/barrel.png
F 100, 100, 100
C 100, 150, 250



1111111111111111111111111111111111111
1000000000000001000000000000000200001
1000000002000001000000000000000000001
1000100001000001000010000100000200001
1000100001000001000010000100001011111 
1000100001000001000010000000001000001
1000111111111001000010000000001000001 
1000000000001001000010000111111111111
1000000000001000000010000000000001111
1111111111111000000011111111111111111
1000100010101111111110000011111111111
1020101010100000100000001000000001001
1000101010101010100111111111011111001
1111000000000000000000000011111111111
1000101010001010101000001000000000001
1000001010111010001001001111111111111 
1020001010111111101001001002010111111
1000001010000000100001001001010111111
10N0010111111101002010010010101001011
1000001000000000100001000001000111111
1111111111111111111111111111111111111
