NO ./pics/pink.png
WE ./pics/blue.png      
SO ./pics/yellow.png    
EA ./pics/green.png    
F  80, 0, 70
C  200, 0, 0
S  ./pics/unicorn.png
R  1200 550 
1111111111
111111111
10E000001
100000001
100000001
100000001
100020001
100200201
111111111
