R  3500 3500
NO ./pics/pink.png      
WE ./pics/blue.png      
SO ./pics/yellow.png    
EA ./pics/green.png     
F  80, 0, 70  
C  0, 230, 230
S  ./pics/uni corn.png

111111111111100000000002
100000000000100000000002
100000000000111111111111
100000001000000010000001
100000020000000000200001
100000000000000000000001
100002000000200N00000001
100000000000000000000001
111111111111111111111111
