R   1600 1204
NO ./pics/pink.png
WE ./pics/blue.png      
SO ./pics/yellow.png    
EA ./pics/green.png 
F  80, 0, 70
C  0, 0, 0
S  ./pics/uni corn.png

000011111111100000000002
000010000000100000000002
111110000000111111111111
100000001000000010000001
100000020000000000200001
100000000000000000000001
10002000000200N000000001
100000000000000000000001
111111111111111111111111