R 330 330
NO./pics/pink.png
WE./pics/blue.png      
SO./pics/yellow.png    
EA./pics/green.png 
F80, 0, 70
C0, 0, 0
S./pics/uni corn.png

00001111111110000  0000002
000010000000100000  000002
11111000000011111111  1111
100000001000000010000   001
1000000200000000002000   01
10000000000000000000000    1 
10002000000200N0000000    01
100000000000000000000    001
11111111111111111111    1111