R 1200 800
C 0, 0, 9
F 80,70,8
NO ./pics/pink.png
WE ./pics/blue.png
SO ./pics/yellow.png
EA ./pics/green.png
S ./pics/uni corn.png

        111111111111111
11111111111110000002000211
10000000000010000000000211
11111000000211111111111111
1111100001000000010000001111
    100000020000000000200001
1111100000000000000000011111
10002000000200N00000000111
1111110002000000000000001
    1000000000000011111111
111111111111111111111
