R 1200 1200
NO ./pics/pink.png
WE ./pics/blue.png
SO ./pics/yellow.png 
EA ./pics/green.png 
F 0, 0, 0
C ./pics/star2.png
S ./pics/uni corn.png
S2 ./pics/snake_2.png


    11111111111111
111110000000000201
103000011100111111
1111111000001
    1000N0001
    100000001
    111111111