R  550 1234
NO ./pics/pink.png
WE ./pics/blue.png      
SO ./pics/yellow.png    
EA ./pics/green.png     
F  80, 0, 70
C  ./pics/star2.png
S  ./pics/uni corn.png
S2 ./pics/snake_2.png

000011111111100000000002
000010300000100000300002
111110000000111111111111
100000001000000010030001
100000020000003000200001
100000000000000000000001
10002000000200N000030001
100000000000000000000001
111111111111111111111111
