R 1000 800
NO image/yellow.png
WE image/pink.png
SO image/blue.png
EA image/green.png

S image/barrel.png
F 100, 100, 100
C 100, 150, 250

1111111111111111
1000000000000001
1000000N00002001
1000011110111001
1000011110111001
1000011110111001
1000000000020001
1000000000000001
1000200000000001
1000011110111001
1000011110111001
1000011110111001
1000000000000001
1111111111111111