R 1024 620
NO pics/greystone.png
WE pics/redbrick.png
SO pics/eagle.png
EA pics/greystone.png
ß
S pics/barrel.png
F 100, 100, 100
C 100, 150, 250

1111111111111111
1222222222222221
1000000000000001
1000111111100001
1000000000000001
1000020000000001
1000000000000001
1000000000000001
1000000020000001
1000000000000001
1000011111100001
1000000000000001
10020000N0001101
1000000000000001
1002000000020001
1000000000000001
1001111000011101
1000000000020001
1222222222222221
1111111111111111

