R1600 1204      
NO./pics/pink.png
WE./pics/blue.png

SO./pics/yellow.png 
EA./pics/green.png 
F80, 0, 70
C./pics/star2.png
S./pics/uni corn.png
S2./pics/snake_2.png

000011111111100000000002
0000100000001   00000000002
111110003000111111111111
100000001000000010000001
10000   0020000330000200001
1000000000000   00000000001
10002000000200N000000001
100000003000   000000300001
111111111111111111111111